//MAP CONVERTED BY dmm2tgm.py THIS HEADER COMMENT PREVENTS RECONVERSION, DO NOT REMOVE
"a" = (
/obj/effect/spawner/structure/window/reinforced/tinted,
/turf/open/floor/plating,
/area/template_noop)
"b" = (
/obj/machinery/door/airlock/public/glass{
	name = "Bar"
	},
/obj/machinery/door/firedoor,
/turf/open/floor/wood,
/area/template_noop)
"c" = (
/obj/structure/cable/yellow{
	icon_state = "4-8"
	},
/obj/machinery/atmospherics/pipe/simple/scrubbers/hidden/layer3{
	dir = 4
	},
/obj/machinery/atmospherics/pipe/manifold/supply/hidden/layer1,
/turf/open/space/basic,
/area/template_noop)
"d" = (
/obj/machinery/door/airlock{
	name = "Bar Storage";
	req_access_txt = "25"
	},
/obj/structure/disposalpipe/segment,
/obj/effect/turf_decal/stripes/line,
/obj/effect/turf_decal/stripes/line{
	dir = 1
	},
/obj/machinery/door/firedoor,
/turf/open/floor/wood,
/area/template_noop)
"g" = (
/obj/machinery/atmospherics/components/unary/vent_scrubber/on/layer3,
/turf/open/space/basic,
/area/template_noop)
"l" = (
/turf/closed/wall,
/area/template_noop)
"o" = (
/obj/structure/cable/yellow{
	icon_state = "4-8"
	},
/obj/machinery/atmospherics/pipe/simple/scrubbers/hidden/layer3{
	dir = 4
	},
/obj/machinery/atmospherics/pipe/simple/supply/hidden/layer1{
	dir = 4
	},
/turf/open/space/basic,
/area/template_noop)
"p" = (
/obj/machinery/atmospherics/components/unary/vent_pump/on/layer1,
/turf/open/space/basic,
/area/template_noop)
"q" = (
/obj/machinery/door/airlock{
	name = "Bar Access";
	req_access_txt = "25"
	},
/obj/effect/turf_decal/stripes/line{
	dir = 8
	},
/obj/effect/turf_decal/stripes/line{
	dir = 4
	},
/obj/machinery/door/firedoor,
/turf/open/floor/wood,
/area/template_noop)
"u" = (
/obj/structure/cable/yellow{
	icon_state = "4-8"
	},
/obj/machinery/door/airlock/public/glass{
	name = "Bar"
	},
/obj/machinery/atmospherics/pipe/simple/supply/hidden/layer1{
	dir = 4
	},
/obj/machinery/door/firedoor,
/obj/machinery/atmospherics/pipe/simple/scrubbers/hidden/layer3{
	dir = 4
	},
/turf/open/floor/wood,
/area/template_noop)
"y" = (
/turf/open/space/basic,
/area/template_noop)
"F" = (
/obj/machinery/smartfridge/drinks{
	icon_state = "boozeomat"
	},
/turf/closed/wall,
/area/template_noop)
"G" = (
/obj/structure/cable/yellow{
	icon_state = "4-8"
	},
/obj/machinery/door/firedoor,
/obj/machinery/atmospherics/pipe/simple/scrubbers/hidden/layer3{
	dir = 4
	},
/obj/machinery/atmospherics/pipe/simple/supply/hidden/layer1{
	dir = 4
	},
/obj/machinery/door/airlock/wood,
/turf/open/floor/wood,
/area/template_noop)
"H" = (
/obj/machinery/firealarm{
	dir = 4;
	pixel_x = -26
	},
/turf/open/space/basic,
/area/template_noop)
"L" = (
/obj/structure/disposalpipe/trunk{
	dir = 8
	},
/obj/machinery/disposal/bin,
/obj/machinery/light_switch{
	pixel_x = 25
	},
/turf/open/space/basic,
/area/template_noop)
"O" = (
/obj/machinery/door/firedoor,
/obj/machinery/door/airlock/wood,
/turf/open/floor/wood,
/area/template_noop)
"Q" = (
/obj/structure/disposalpipe/segment{
	dir = 5
	},
/turf/open/space/basic,
/area/template_noop)
"S" = (
/obj/structure/cable/yellow{
	icon_state = "4-8"
	},
/obj/machinery/atmospherics/pipe/simple/supply/hidden/layer1{
	dir = 4
	},
/obj/machinery/atmospherics/pipe/manifold/scrubbers/hidden/layer3,
/turf/open/space/basic,
/area/template_noop)
"W" = (
/obj/machinery/airalarm{
	dir = 1;
	pixel_y = -22
	},
/turf/open/space/basic,
/area/template_noop)

(1,1,1) = {"
l
a
a
l
a
b
u
a
l
"}
(2,1,1) = {"
H
y
y
y
y
y
o
y
W
"}
(3,1,1) = {"
y
y
y
y
y
y
o
y
y
"}
(4,1,1) = {"
y
y
y
y
y
y
o
y
y
"}
(5,1,1) = {"
l
y
y
y
y
g
S
y
y
"}
(6,1,1) = {"
l
y
y
y
y
p
c
y
y
"}
(7,1,1) = {"
d
Q
y
y
y
y
o
y
y
"}
(8,1,1) = {"
l
L
y
y
y
y
o
y
y
"}
(9,1,1) = {"
l
l
q
F
l
O
G
l
l
"}
