//MAP CONVERTED BY dmm2tgm.py THIS HEADER COMMENT PREVENTS RECONVERSION, DO NOT REMOVE
"ay" = (
/obj/structure/window/reinforced/spawner/west,
/obj/structure/table/glass,
/obj/item/reagent_containers/glass/beaker/large{
	pixel_y = -2;
	pixel_x = -2
	},
/obj/item/reagent_containers/glass/beaker{
	pixel_y = 10
	},
/obj/item/reagent_containers/glass/beaker{
	pixel_x = 10;
	pixel_y = 8
	},
/obj/item/reagent_containers/glass/beaker{
	pixel_x = 11;
	pixel_y = -1
	},
/turf/open/floor/plasteel/white,
/area/template_noop)
"bD" = (
/obj/structure/cable/yellow{
	icon_state = "4-8"
	},
/obj/machinery/atmospherics/pipe/simple/supply/hidden/layer1{
	dir = 4
	},
/obj/machinery/atmospherics/pipe/manifold/scrubbers/hidden/layer3,
/obj/machinery/computer/cloning,
/turf/open/floor/plasteel/white,
/area/template_noop)
"cv" = (
/obj/structure/cable/yellow{
	icon_state = "4-8"
	},
/obj/machinery/atmospherics/pipe/simple/scrubbers/hidden/layer3{
	dir = 4
	},
/obj/machinery/atmospherics/pipe/simple/supply/hidden/layer1{
	dir = 4
	},
/obj/effect/turf_decal/trimline/darkblue/line{
	dir = 8
	},
/obj/effect/turf_decal/trimline/darkblue/line{
	dir = 4
	},
/turf/open/floor/plasteel/white,
/area/template_noop)
"dX" = (
/obj/structure/disposalpipe/segment{
	dir = 5
	},
/turf/open/floor/plasteel/white,
/area/template_noop)
"eC" = (
/obj/structure/cable/yellow{
	icon_state = "4-8"
	},
/obj/machinery/atmospherics/pipe/simple/scrubbers/hidden/layer3{
	dir = 4
	},
/obj/machinery/atmospherics/pipe/simple/supply/hidden/layer1{
	dir = 4
	},
/turf/open/floor/plasteel/white,
/area/template_noop)
"eZ" = (
/obj/structure/cable/yellow{
	icon_state = "4-8"
	},
/obj/machinery/door/firedoor,
/obj/machinery/atmospherics/pipe/simple/scrubbers/hidden/layer3{
	dir = 4
	},
/obj/machinery/atmospherics/pipe/simple/supply/hidden/layer1{
	dir = 4
	},
/obj/machinery/door/airlock/medical,
/turf/open/floor/plasteel/white,
/area/template_noop)
"fx" = (
/obj/effect/turf_decal/trimline/darkblue/line,
/obj/effect/turf_decal/trimline/darkblue/line{
	dir = 1
	},
/turf/open/floor/plasteel/white,
/area/template_noop)
"gc" = (
/obj/effect/turf_decal/trimline/darkblue/filled/warning,
/obj/effect/turf_decal/trimline/darkblue/line,
/obj/effect/turf_decal/trimline/darkblue/line,
/turf/open/floor/plasteel/white,
/area/template_noop)
"hq" = (
/obj/structure/chair/office/light{
	dir = 1
	},
/obj/effect/turf_decal/trimline/darkblue/filled/warning{
	dir = 1
	},
/obj/effect/turf_decal/trimline/darkblue/line{
	dir = 1
	},
/turf/open/floor/plasteel/white,
/area/template_noop)
"hu" = (
/obj/effect/turf_decal/tile/darkblue/tile_marquee,
/turf/open/floor/plasteel/white,
/area/template_noop)
"iK" = (
/mob/living/carbon/monkey/punpun,
/obj/machinery/light{
	dir = 4
	},
/turf/open/floor/plasteel/white,
/area/template_noop)
"jn" = (
/obj/structure/table/glass,
/obj/item/toy/figure/md{
	pixel_y = 12;
	pixel_x = -9;
	toysay = "I NEEEEEEEEEEEEEEEEED A MEDIC BAG"
	},
/turf/open/floor/plasteel/white,
/area/template_noop)
"kw" = (
/obj/structure/table/glass,
/obj/structure/table/glass,
/obj/item/lighter,
/obj/item/reagent_containers/glass/rag{
	pixel_x = 10;
	pixel_y = 12
	},
/turf/open/floor/plasteel/white,
/area/template_noop)
"kZ" = (
/obj/effect/turf_decal/trimline/darkblue/line{
	dir = 1
	},
/obj/effect/turf_decal/trimline/darkblue/warning,
/obj/effect/turf_decal/trimline/darkblue/corner,
/obj/effect/turf_decal/trimline/darkblue/corner{
	dir = 8
	},
/turf/open/floor/plasteel/white,
/area/template_noop)
"lQ" = (
/obj/structure/sign/departments/medbay/alt,
/turf/closed/wall,
/area/template_noop)
"mQ" = (
/obj/machinery/smartfridge/drinks{
	icon_state = "boozeomat"
	},
/turf/closed/wall,
/area/template_noop)
"ns" = (
/obj/effect/turf_decal/trimline/darkblue/line{
	dir = 6
	},
/obj/effect/turf_decal/trimline/darkblue/corner{
	dir = 1
	},
/turf/open/floor/plasteel/white,
/area/template_noop)
"pg" = (
/obj/machinery/door/window/westright,
/obj/structure/table/glass,
/obj/item/reagent_containers/glass/bottle/ethanol,
/obj/item/reagent_containers/glass/bottle/oxygen{
	pixel_x = -6;
	pixel_y = 6
	},
/obj/item/reagent_containers/glass/bottle/sugar{
	pixel_y = 11;
	pixel_x = 6
	},
/obj/item/reagent_containers/glass/bottle/welding_fuel{
	pixel_x = 9
	},
/turf/open/floor/plasteel/white,
/area/template_noop)
"qD" = (
/obj/structure/window/reinforced/spawner,
/obj/structure/window/reinforced/spawner/east,
/obj/machinery/vending/boozeomat,
/turf/open/floor/plasteel/white,
/area/template_noop)
"rC" = (
/obj/effect/turf_decal/trimline/darkblue/line{
	dir = 1
	},
/obj/effect/turf_decal/trimline/darkblue/warning,
/obj/effect/turf_decal/trimline/darkblue/corner{
	dir = 8
	},
/obj/effect/turf_decal/trimline/darkblue/corner,
/turf/open/floor/plasteel/white,
/area/template_noop)
"sa" = (
/obj/machinery/firealarm{
	dir = 4;
	pixel_x = -26
	},
/obj/effect/spawner/bundle/costume/plaguedoctor,
/obj/structure/sink/kitchen{
	pixel_y = 22
	},
/obj/effect/landmark/start/bartender,
/obj/effect/turf_decal/tile/darkblue/tile_marquee,
/turf/open/floor/plasteel/white,
/area/template_noop)
"tO" = (
/obj/structure/table/glass,
/obj/machinery/chem_dispenser/drinks/beer,
/turf/open/floor/plasteel/white,
/area/template_noop)
"xv" = (
/obj/effect/turf_decal/trimline/darkblue/line{
	dir = 1
	},
/obj/effect/turf_decal/trimline/darkblue/line,
/turf/open/floor/plasteel/white,
/area/template_noop)
"xA" = (
/obj/effect/turf_decal/trimline/darkblue/filled/warning,
/turf/open/floor/plasteel/white,
/area/template_noop)
"xC" = (
/obj/machinery/door/airlock{
	name = "Bar Storage";
	req_access_txt = "25"
	},
/obj/structure/disposalpipe/segment,
/obj/effect/turf_decal/stripes/line,
/obj/effect/turf_decal/stripes/line{
	dir = 1
	},
/obj/machinery/door/firedoor,
/turf/open/floor/wood,
/area/template_noop)
"yc" = (
/obj/effect/turf_decal/tile/darkblue/tile_marquee,
/obj/effect/landmark/event_spawn,
/turf/open/floor/plasteel/white,
/area/template_noop)
"yL" = (
/obj/machinery/door/firedoor,
/obj/machinery/door/airlock/medical,
/turf/open/floor/plasteel/white,
/area/template_noop)
"yW" = (
/obj/effect/turf_decal/trimline/darkblue/line,
/obj/effect/turf_decal/trimline/darkblue/corner{
	dir = 4
	},
/obj/effect/turf_decal/trimline/darkblue/warning{
	dir = 1
	},
/turf/open/floor/plasteel/white,
/area/template_noop)
"zc" = (
/obj/effect/turf_decal/trimline/darkblue/line{
	dir = 10
	},
/obj/effect/turf_decal/trimline/darkblue/corner{
	dir = 4
	},
/turf/open/floor/plasteel/white,
/area/template_noop)
"BG" = (
/obj/structure/cable/yellow{
	icon_state = "4-8"
	},
/obj/machinery/atmospherics/pipe/simple/scrubbers/hidden/layer3{
	dir = 4
	},
/obj/machinery/atmospherics/pipe/manifold/supply/hidden/layer1,
/obj/structure/showcase/machinery/cloning_pod,
/obj/effect/turf_decal/bot_white,
/turf/open/floor/plasteel/white,
/area/template_noop)
"BW" = (
/obj/structure/cable/yellow{
	icon_state = "4-8"
	},
/obj/machinery/atmospherics/pipe/simple/scrubbers/hidden/layer3{
	dir = 4
	},
/obj/machinery/atmospherics/pipe/simple/supply/hidden/layer1{
	dir = 4
	},
/obj/machinery/dna_scannernew,
/turf/open/floor/plasteel/white,
/area/template_noop)
"CK" = (
/obj/structure/chair/office/light,
/obj/effect/turf_decal/trimline/darkblue/filled/warning,
/turf/open/floor/plasteel/white,
/area/template_noop)
"Db" = (
/obj/structure/table/glass,
/obj/item/storage/backpack/duffelbag/med/surgery,
/obj/item/reagent_containers/medspray/sterilizine{
	pixel_x = -6;
	pixel_y = 15
	},
/obj/item/reagent_containers/medspray/sterilizine{
	pixel_x = 6;
	pixel_y = 12
	},
/turf/open/floor/plasteel/white,
/area/template_noop)
"DX" = (
/obj/structure/cable/yellow{
	icon_state = "4-8"
	},
/obj/machinery/atmospherics/pipe/simple/scrubbers/hidden/layer3{
	dir = 4
	},
/obj/machinery/atmospherics/pipe/simple/supply/hidden/layer1{
	dir = 4
	},
/obj/effect/turf_decal/trimline/darkblue/line{
	dir = 4
	},
/obj/effect/turf_decal/trimline/darkblue/line{
	dir = 8
	},
/turf/open/floor/plasteel/white,
/area/template_noop)
"Ee" = (
/obj/structure/table/glass,
/turf/open/floor/plasteel/white,
/area/template_noop)
"FB" = (
/turf/closed/wall,
/area/template_noop)
"FJ" = (
/obj/structure/table/glass,
/obj/item/clothing/mask/surgical{
	pixel_x = -1
	},
/turf/open/floor/plasteel/white,
/area/template_noop)
"FT" = (
/obj/structure/sink/kitchen{
	dir = 8;
	pixel_y = 1;
	pixel_x = 11
	},
/obj/machinery/light{
	dir = 4
	},
/obj/effect/turf_decal/trimline/darkblue/filled/warning{
	dir = 1
	},
/obj/effect/turf_decal/trimline/darkblue/line{
	dir = 1
	},
/turf/open/floor/plasteel/white,
/area/template_noop)
"Gw" = (
/obj/structure/table/glass,
/obj/machinery/chem_dispenser/drinks,
/obj/machinery/light{
	dir = 4
	},
/turf/open/floor/plasteel/white,
/area/template_noop)
"Ic" = (
/obj/structure/table/glass,
/obj/structure/displaycase/forsale/kitchen{
	pixel_y = 9
	},
/turf/open/floor/plasteel/white,
/area/template_noop)
"Il" = (
/obj/machinery/light{
	dir = 8
	},
/obj/structure/bed/roller,
/obj/structure/bed/roller,
/obj/effect/turf_decal/delivery,
/turf/open/floor/plasteel/white,
/area/template_noop)
"IV" = (
/obj/effect/turf_decal/stripes/line{
	dir = 8
	},
/obj/effect/turf_decal/stripes/line{
	dir = 4
	},
/obj/machinery/door/firedoor,
/obj/machinery/door/airlock/medical{
	req_access_txt = "25"
	},
/turf/open/floor/white,
/area/template_noop)
"Jd" = (
/obj/structure/chair/office/light,
/obj/effect/landmark/start/assistant,
/obj/effect/turf_decal/trimline/darkblue/filled/warning,
/turf/open/floor/plasteel/white,
/area/template_noop)
"Ni" = (
/obj/structure/table/glass,
/obj/item/reagent_containers/food/condiment/saltshaker,
/obj/item/reagent_containers/food/condiment/peppermill{
	pixel_x = 8
	},
/obj/machinery/light{
	dir = 8
	},
/turf/open/floor/plasteel/white,
/area/template_noop)
"Ob" = (
/obj/machinery/atmospherics/components/unary/vent_scrubber/on/layer3,
/obj/effect/turf_decal/trimline/darkblue/line,
/obj/effect/turf_decal/trimline/darkblue/line{
	dir = 1
	},
/obj/effect/landmark/event_spawn,
/turf/open/floor/plasteel/white,
/area/template_noop)
"OI" = (
/obj/structure/table/glass,
/obj/item/clothing/mask/surgical{
	pixel_y = 4
	},
/turf/open/floor/plasteel/white,
/area/template_noop)
"QE" = (
/obj/effect/landmark/start/bartender,
/obj/effect/turf_decal/trimline/darkblue/filled/warning,
/obj/effect/turf_decal/trimline/darkblue/line,
/turf/open/floor/plasteel/white,
/area/template_noop)
"Si" = (
/obj/structure/window/reinforced/spawner/west,
/obj/structure/table/glass,
/obj/item/reagent_containers/glass/bottle/phosphorus{
	pixel_y = 7
	},
/obj/item/reagent_containers/glass/bottle/nitrogen{
	pixel_x = 10
	},
/obj/structure/window/reinforced/spawner,
/turf/open/floor/plasteel/white,
/area/template_noop)
"Sv" = (
/obj/structure/table/optable,
/obj/structure/sign/barsign{
	pixel_x = -32;
	pixel_y = 33
	},
/obj/item/book/manual/wiki/barman_recipes,
/turf/open/floor/plasteel/white,
/area/template_noop)
"Tf" = (
/obj/machinery/atmospherics/components/unary/vent_pump/on/layer1,
/obj/effect/turf_decal/trimline/darkblue/line,
/obj/effect/turf_decal/trimline/darkblue/line{
	dir = 1
	},
/turf/open/floor/plasteel/white,
/area/template_noop)
"TB" = (
/obj/machinery/computer/operating,
/turf/open/floor/plasteel/white,
/area/template_noop)
"VD" = (
/obj/structure/cable/yellow{
	icon_state = "4-8"
	},
/obj/machinery/atmospherics/pipe/simple/supply/hidden/layer1{
	dir = 4
	},
/obj/machinery/door/firedoor,
/obj/machinery/door/airlock/medical,
/obj/machinery/atmospherics/pipe/simple/scrubbers/hidden/layer3{
	dir = 4
	},
/turf/open/floor/plasteel/white,
/area/template_noop)
"YB" = (
/obj/effect/turf_decal/trimline/darkblue/filled/warning,
/obj/effect/turf_decal/trimline/darkblue/line,
/turf/open/floor/plasteel/white,
/area/template_noop)
"Zi" = (
/obj/structure/table/glass,
/obj/item/kitchen/fork,
/obj/item/kitchen/fork{
	pixel_x = -9
	},
/obj/item/kitchen/fork{
	pixel_x = 8
	},
/obj/machinery/airalarm{
	dir = 1;
	pixel_y = -22
	},
/turf/open/floor/plasteel/white,
/area/template_noop)
"ZB" = (
/obj/structure/disposalpipe/trunk{
	dir = 8
	},
/obj/machinery/disposal/bin,
/obj/machinery/light_switch{
	pixel_x = 25
	},
/obj/effect/turf_decal/box/red,
/turf/open/floor/plasteel/white,
/area/template_noop)

(1,1,1) = {"
FB
ay
pg
Si
lQ
yL
VD
lQ
FB
"}
(2,1,1) = {"
sa
hu
hu
qD
Il
yW
eC
Ni
Zi
"}
(3,1,1) = {"
tO
yc
YB
jn
hq
rC
cv
zc
Ee
"}
(4,1,1) = {"
Gw
Db
YB
kw
hq
fx
BW
fx
Jd
"}
(5,1,1) = {"
FB
TB
QE
Ic
hq
Ob
bD
xv
xA
"}
(6,1,1) = {"
FB
Sv
gc
OI
hq
Tf
BG
fx
CK
"}
(7,1,1) = {"
xC
dX
YB
Ee
hq
kZ
DX
ns
xA
"}
(8,1,1) = {"
FB
ZB
YB
FJ
FT
fx
eC
iK
CK
"}
(9,1,1) = {"
FB
FB
IV
mQ
FB
yL
eZ
FB
FB
"}
