//MAP CONVERTED BY dmm2tgm.py THIS HEADER COMMENT PREVENTS RECONVERSION, DO NOT REMOVE
"bG" = (
/obj/machinery/atmospherics/pipe/simple/supply/hidden/layer1{
	dir = 9
	},
/obj/machinery/atmospherics/pipe/simple/scrubbers/hidden/layer3{
	dir = 9
	},
/turf/open/space/basic,
/area/template_noop)
"bI" = (
/obj/structure/disposalpipe/segment{
	dir = 9
	},
/turf/open/space/basic,
/area/template_noop)
"io" = (
/obj/effect/spawner/structure/window,
/turf/open/floor/plating,
/area/template_noop)
"iT" = (
/obj/machinery/disposal/bin,
/obj/structure/disposalpipe/trunk{
	dir = 4
	},
/obj/machinery/button/door{
	id = "barShutters";
	name = "bar shutters";
	pixel_x = 4;
	pixel_y = 28
	},
/turf/open/space/basic,
/area/template_noop)
"jP" = (
/turf/open/space/basic,
/area/template_noop)
"mh" = (
/obj/machinery/atmospherics/pipe/simple/supply/hidden/layer1{
	dir = 8
	},
/obj/machinery/atmospherics/pipe/simple/scrubbers/hidden/layer3{
	dir = 8
	},
/turf/open/space/basic,
/area/template_noop)
"mn" = (
/obj/effect/landmark/event_spawn,
/turf/open/space/basic,
/area/template_noop)
"nl" = (
/obj/machinery/atmospherics/pipe/simple/supply/hidden/layer1{
	dir = 1
	},
/obj/machinery/atmospherics/pipe/simple/scrubbers/hidden/layer3,
/turf/open/space/basic,
/area/template_noop)
"nu" = (
/obj/effect/landmark/event_spawn,
/obj/effect/spawner/xmastree,
/obj/machinery/atmospherics/pipe/simple/supply/hidden/layer1{
	dir = 9
	},
/obj/machinery/atmospherics/pipe/simple/scrubbers/hidden/layer3{
	dir = 5
	},
/turf/open/space/basic,
/area/template_noop)
"zf" = (
/obj/machinery/door/airlock/public/glass{
	name = "Diner"
	},
/obj/machinery/door/firedoor,
/turf/open/floor/plasteel,
/area/template_noop)
"DW" = (
/obj/effect/landmark/start/bartender,
/turf/open/space/basic,
/area/template_noop)
"Et" = (
/obj/machinery/atmospherics/pipe/simple/supply/hidden/layer1{
	dir = 6
	},
/obj/machinery/atmospherics/pipe/simple/scrubbers/hidden/layer3{
	dir = 6
	},
/turf/open/space/basic,
/area/template_noop)
"Fd" = (
/obj/machinery/atmospherics/components/unary/vent_scrubber/on/layer3{
	dir = 8
	},
/turf/open/space/basic,
/area/template_noop)
"Ld" = (
/obj/effect/landmark/start/assistant,
/turf/open/space/basic,
/area/template_noop)
"MB" = (
/turf/closed/wall,
/area/template_noop)
"NX" = (
/obj/structure/chair/stool/bar,
/obj/effect/landmark/start/assistant,
/turf/open/space/basic,
/area/template_noop)
"WE" = (
/obj/structure/sign/barsign,
/turf/closed/wall,
/area/template_noop)
"Xr" = (
/obj/machinery/atmospherics/components/unary/vent_pump/on/layer1{
	dir = 4
	},
/turf/open/space/basic,
/area/template_noop)
"ZI" = (
/obj/effect/spawner/structure/window,
/obj/machinery/door/poddoor/preopen{
	id = "barShutters";
	name = "privacy shutters"
	},
/turf/open/floor/plating,
/area/template_noop)

(1,1,1) = {"
MB
MB
ZI
MB
zf
MB
ZI
MB
MB
"}
(2,1,1) = {"
jP
jP
jP
jP
jP
jP
jP
jP
MB
"}
(3,1,1) = {"
jP
jP
jP
jP
jP
jP
jP
jP
MB
"}
(4,1,1) = {"
jP
Ld
jP
jP
jP
jP
jP
jP
MB
"}
(5,1,1) = {"
jP
jP
jP
Xr
jP
jP
jP
jP
MB
"}
(6,1,1) = {"
jP
Et
nl
nu
jP
jP
jP
jP
zf
"}
(7,1,1) = {"
jP
mh
jP
Fd
jP
jP
jP
jP
ZI
"}
(8,1,1) = {"
jP
mh
jP
jP
jP
jP
Ld
jP
zf
"}
(9,1,1) = {"
jP
mh
jP
jP
jP
jP
jP
jP
WE
"}
(10,1,1) = {"
nl
bG
jP
jP
jP
jP
jP
jP
MB
"}
(11,1,1) = {"
io
jP
jP
jP
jP
jP
jP
jP
MB
"}
(12,1,1) = {"
MB
jP
jP
jP
jP
jP
NX
jP
MB
"}
(13,1,1) = {"
iT
jP
jP
DW
jP
jP
mn
jP
MB
"}
(14,1,1) = {"
bI
jP
jP
jP
jP
jP
jP
jP
MB
"}
(15,1,1) = {"
jP
jP
jP
jP
jP
jP
jP
jP
MB
"}
