//MAP CONVERTED BY dmm2tgm.py THIS HEADER COMMENT PREVENTS RECONVERSION, DO NOT REMOVE
"ab" = (
/obj/machinery/vending/cigarette,
/obj/effect/decal/cleanable/dirt,
/turf/open/floor/mineral/plastitanium/red,
/area/template_noop)
"bG" = (
/obj/machinery/atmospherics/pipe/simple/supply/hidden/layer1{
	dir = 9
	},
/obj/machinery/atmospherics/pipe/simple/scrubbers/hidden/layer3{
	dir = 9
	},
/obj/effect/turf_decal/loading_area{
	dir = 8
	},
/obj/effect/decal/cleanable/dirt,
/turf/open/floor/mineral/plastitanium,
/area/template_noop)
"bI" = (
/obj/structure/disposalpipe/segment{
	dir = 9
	},
/obj/effect/decal/cleanable/dirt,
/turf/open/floor/mineral/plastitanium,
/area/template_noop)
"dJ" = (
/obj/structure/table/reinforced,
/obj/item/clothing/under/syndicate/tacticool,
/obj/effect/decal/cleanable/dirt,
/turf/open/floor/mineral/plastitanium/red,
/area/template_noop)
"fF" = (
/obj/machinery/atmospherics/pipe/simple/supply/hidden/layer1{
	dir = 8
	},
/obj/machinery/atmospherics/pipe/simple/scrubbers/hidden/layer3{
	dir = 8
	},
/obj/effect/decal/cleanable/dirt,
/turf/open/floor/mineral/plastitanium,
/area/template_noop)
"fK" = (
/obj/structure/chair/stool/bar,
/obj/effect/decal/cleanable/dirt,
/turf/open/floor/mineral/plastitanium,
/area/template_noop)
"fP" = (
/obj/effect/turf_decal/stripes/openup{
	dir = 9
	},
/obj/effect/decal/cleanable/dirt,
/turf/open/floor/mineral/plastitanium/red,
/area/template_noop)
"gj" = (
/obj/effect/turf_decal/stripes/line{
	dir = 8
	},
/obj/effect/turf_decal/stripes/line{
	dir = 4
	},
/obj/effect/landmark/start/assistant,
/obj/effect/decal/cleanable/blood/old,
/obj/effect/decal/cleanable/dirt,
/turf/open/floor/mineral/plastitanium/red,
/area/template_noop)
"gw" = (
/obj/machinery/computer/arcade{
	dir = 8;
	pixel_x = 4
	},
/obj/effect/decal/cleanable/dirt,
/turf/open/floor/mineral/plastitanium/red,
/area/template_noop)
"gH" = (
/obj/structure/table/reinforced,
/obj/item/gun/ballistic/automatic/toy/pistol/riot/unrestricted{
	pixel_y = 3
	},
/obj/effect/decal/cleanable/dirt,
/turf/open/floor/mineral/plastitanium,
/area/template_noop)
"io" = (
/obj/structure/chair/comfy/black{
	dir = 4;
	pixel_x = 9;
	pixel_y = 6
	},
/obj/effect/decal/cleanable/dirt,
/turf/open/floor/mineral/plastitanium,
/area/template_noop)
"iB" = (
/obj/effect/turf_decal/stripes/line{
	dir = 6
	},
/obj/effect/decal/cleanable/dirt,
/turf/open/floor/mineral/plastitanium/red,
/area/template_noop)
"iT" = (
/obj/machinery/disposal/bin,
/obj/structure/disposalpipe/trunk{
	dir = 4
	},
/obj/machinery/button/door{
	id = "barShutters";
	name = "bar shutters";
	pixel_x = 4;
	pixel_y = 28
	},
/obj/effect/decal/cleanable/dirt,
/turf/open/floor/mineral/plastitanium/red,
/area/template_noop)
"kV" = (
/obj/machinery/vending/boozeomat,
/turf/closed/wall/mineral/plastitanium,
/area/template_noop)
"mh" = (
/obj/machinery/atmospherics/pipe/simple/supply/hidden/layer1{
	dir = 8
	},
/obj/machinery/atmospherics/pipe/simple/scrubbers/hidden/layer3{
	dir = 8
	},
/turf/closed/wall/mineral/plastitanium,
/area/template_noop)
"mn" = (
/obj/effect/landmark/event_spawn,
/obj/structure/table/reinforced,
/obj/machinery/chem_dispenser/drinks{
	dir = 4;
	pixel_x = -3;
	pixel_y = 3
	},
/obj/effect/decal/cleanable/dirt,
/turf/open/floor/mineral/plastitanium/red,
/area/template_noop)
"mt" = (
/obj/machinery/atmospherics/pipe/simple/supply/hidden/layer1{
	dir = 1
	},
/obj/machinery/atmospherics/pipe/simple/scrubbers/hidden/layer3,
/obj/effect/decal/cleanable/dirt,
/turf/open/floor/mineral/plastitanium,
/area/template_noop)
"ni" = (
/obj/structure/falsewall/plastitanium,
/turf/open/floor/mineral/plastitanium,
/area/template_noop)
"nl" = (
/obj/machinery/atmospherics/pipe/simple/supply/hidden/layer1{
	dir = 1
	},
/obj/machinery/atmospherics/pipe/simple/scrubbers/hidden/layer3,
/obj/structure/chair/comfy/black{
	dir = 8;
	pixel_x = -7;
	pixel_y = 6
	},
/obj/effect/decal/cleanable/dirt,
/turf/open/floor/mineral/plastitanium,
/area/template_noop)
"nu" = (
/obj/effect/landmark/event_spawn,
/obj/effect/spawner/xmastree,
/obj/machinery/atmospherics/pipe/simple/supply/hidden/layer1{
	dir = 9
	},
/obj/machinery/atmospherics/pipe/simple/scrubbers/hidden/layer3{
	dir = 5
	},
/obj/effect/decal/cleanable/dirt,
/turf/open/floor/mineral/plastitanium,
/area/template_noop)
"oK" = (
/obj/structure/chair/comfy/black{
	dir = 1;
	pixel_y = 13
	},
/obj/effect/decal/cleanable/dirt,
/turf/open/floor/mineral/plastitanium,
/area/template_noop)
"oV" = (
/obj/structure/window/spawner/east,
/obj/effect/decal/cleanable/dirt,
/obj/effect/turf_decal/stripes{
	dir = 4
	},
/turf/open/floor/mineral/plastitanium,
/area/template_noop)
"qX" = (
/obj/structure/chair/comfy/black{
	pixel_y = -3
	},
/obj/effect/decal/cleanable/dirt,
/turf/open/floor/mineral/plastitanium,
/area/template_noop)
"sO" = (
/obj/effect/turf_decal/loading_area{
	dir = 1
	},
/obj/effect/turf_decal/stripes/line{
	dir = 8
	},
/obj/effect/turf_decal/stripes/line{
	dir = 4
	},
/obj/effect/decal/cleanable/dirt,
/turf/open/floor/mineral/plastitanium/red,
/area/template_noop)
"tk" = (
/obj/item/reagent_containers/food/drinks/drinkingglass{
	pixel_y = 7;
	pixel_x = -7
	},
/obj/item/reagent_containers/food/drinks/bottle/rum{
	pixel_y = 5;
	pixel_x = 5
	},
/obj/structure/table/reinforced,
/turf/open/floor/mineral/plastitanium/red,
/area/template_noop)
"ts" = (
/obj/structure/table/reinforced,
/obj/item/soap/syndie{
	pixel_y = -4
	},
/obj/item/reagent_containers/glass/rag{
	pixel_y = 14;
	pixel_x = 4
	},
/obj/effect/decal/cleanable/dirt,
/obj/item/reagent_containers/food/drinks/drinkingglass{
	pixel_x = -9;
	pixel_y = 15
	},
/obj/item/reagent_containers/food/drinks/drinkingglass{
	pixel_x = -9;
	pixel_y = 11
	},
/turf/open/floor/mineral/plastitanium/red,
/area/template_noop)
"tN" = (
/obj/structure/table/reinforced,
/obj/item/poster/random_contraband,
/obj/item/poster/random_contraband{
	pixel_y = 6
	},
/obj/item/poster/random_contraband{
	pixel_y = 11
	},
/obj/effect/decal/cleanable/dirt,
/turf/open/floor/mineral/plastitanium,
/area/template_noop)
"vA" = (
/obj/structure/table/glass/plasma,
/obj/machinery/door/window/eastleft{
	req_access_txt = "25"
	},
/obj/machinery/door/poddoor/preopen{
	id = "barShutters";
	name = "privacy shutters"
	},
/obj/effect/turf_decal/delivery/red,
/turf/open/floor/mineral/plastitanium,
/area/template_noop)
"wI" = (
/obj/machinery/door/airlock/public/glass{
	name = "Diner"
	},
/obj/machinery/door/firedoor,
/obj/machinery/door/poddoor/preopen{
	id = "barShutters";
	name = "privacy shutters"
	},
/obj/effect/turf_decal/caution{
	dir = 8
	},
/turf/open/floor/mineral/plastitanium/red,
/area/template_noop)
"zf" = (
/obj/machinery/door/airlock/public/glass{
	name = "Diner"
	},
/obj/machinery/door/firedoor,
/obj/machinery/door/poddoor/preopen{
	id = "barShutters";
	name = "privacy shutters"
	},
/obj/effect/turf_decal/caution,
/turf/open/floor/mineral/plastitanium/red,
/area/template_noop)
"zn" = (
/obj/effect/decal/cleanable/dirt,
/obj/structure/table/reinforced,
/turf/open/floor/mineral/plastitanium,
/area/template_noop)
"Af" = (
/obj/structure/sign/poster/contraband/syndicate_recruitment,
/turf/closed/wall/mineral/plastitanium,
/area/template_noop)
"As" = (
/obj/structure/chair/stool/bar,
/obj/effect/landmark/start/assistant,
/obj/effect/decal/cleanable/dirt,
/turf/open/floor/mineral/plastitanium,
/area/template_noop)
"Cj" = (
/obj/structure/chair/comfy/black{
	dir = 8;
	pixel_x = -7;
	pixel_y = 6
	},
/obj/effect/decal/cleanable/dirt,
/turf/open/floor/mineral/plastitanium,
/area/template_noop)
"Dc" = (
/obj/effect/landmark/start/bartender,
/obj/effect/decal/cleanable/dirt,
/turf/open/floor/mineral/plastitanium,
/area/template_noop)
"DU" = (
/obj/machinery/door/airlock/survival_pod/glass{
	req_access_txt = "25"
	},
/obj/machinery/door/poddoor/preopen{
	id = "barShutters";
	name = "privacy shutters"
	},
/turf/open/floor/mineral/plastitanium/red,
/area/template_noop)
"DW" = (
/obj/structure/sink/kitchen{
	dir = 4;
	pixel_x = -11
	},
/obj/effect/decal/cleanable/dirt,
/turf/open/floor/mineral/plastitanium/red,
/area/template_noop)
"Ea" = (
/obj/item/reagent_containers/food/drinks/drinkingglass/filled/nuka_cola{
	pixel_y = 8;
	pixel_x = -8
	},
/obj/structure/table/reinforced,
/turf/open/floor/mineral/plastitanium/red,
/area/template_noop)
"Et" = (
/obj/machinery/atmospherics/pipe/simple/supply/hidden/layer1{
	dir = 6
	},
/obj/machinery/atmospherics/pipe/simple/scrubbers/hidden/layer3{
	dir = 6
	},
/obj/effect/decal/cleanable/dirt,
/turf/open/floor/mineral/plastitanium,
/area/template_noop)
"Fd" = (
/obj/machinery/atmospherics/components/unary/vent_scrubber/on/layer3{
	dir = 8
	},
/mob/living/carbon/monkey/punpun,
/obj/effect/decal/cleanable/dirt,
/turf/open/floor/mineral/plastitanium,
/area/template_noop)
"Gy" = (
/obj/effect/landmark/start/assistant,
/obj/effect/decal/cleanable/dirt,
/turf/open/floor/mineral/plastitanium,
/area/template_noop)
"Hx" = (
/obj/structure/table/reinforced,
/obj/machinery/chem_dispenser/drinks/beer{
	dir = 8;
	pixel_y = 5;
	pixel_x = 4
	},
/obj/effect/decal/cleanable/dirt,
/turf/open/floor/mineral/plastitanium,
/area/template_noop)
"HA" = (
/obj/effect/turf_decal/tile/purple,
/turf/closed/wall/mineral/plastitanium,
/area/template_noop)
"Ia" = (
/obj/structure/sign/poster/contraband,
/turf/closed/wall/mineral/plastitanium,
/area/template_noop)
"Lv" = (
/obj/effect/decal/cleanable/dirt,
/turf/open/floor/mineral/plastitanium/red,
/area/template_noop)
"LM" = (
/turf/closed/wall/mineral/plastitanium,
/area/template_noop)
"MB" = (
/obj/effect/decal/cleanable/dirt,
/turf/open/floor/mineral/plastitanium,
/area/template_noop)
"NX" = (
/obj/effect/spawner/structure/window/plastitanium,
/obj/machinery/door/poddoor/preopen{
	id = "barShutters";
	name = "privacy shutters"
	},
/turf/open/floor/plating,
/area/template_noop)
"SG" = (
/obj/effect/turf_decal/stripes/line{
	dir = 8
	},
/obj/effect/turf_decal/stripes/line{
	dir = 4
	},
/obj/effect/decal/cleanable/dirt,
/turf/open/floor/mineral/plastitanium/red,
/area/template_noop)
"TD" = (
/obj/item/toy/plush/nukeplushie{
	pixel_y = 3
	},
/obj/structure/table/reinforced,
/turf/open/floor/mineral/plastitanium/red,
/area/template_noop)
"UH" = (
/obj/item/reagent_containers/food/drinks/drinkingglass,
/obj/item/reagent_containers/food/drinks/drinkingglass{
	pixel_y = 8;
	pixel_x = 9
	},
/obj/structure/table/reinforced,
/turf/open/floor/mineral/plastitanium/red,
/area/template_noop)
"WE" = (
/obj/structure/sign/barsign,
/turf/closed/wall/mineral/plastitanium,
/area/template_noop)
"Xi" = (
/obj/structure/table/reinforced,
/obj/effect/decal/cleanable/dirt,
/obj/item/reagent_containers/food/drinks/drinkingglass{
	pixel_y = 7;
	pixel_x = -1
	},
/turf/open/floor/mineral/plastitanium,
/area/template_noop)
"Xr" = (
/obj/machinery/atmospherics/components/unary/vent_pump/on/layer1{
	dir = 4
	},
/obj/structure/chair/comfy/black{
	dir = 1;
	pixel_y = 13
	},
/obj/effect/decal/cleanable/dirt,
/turf/open/floor/mineral/plastitanium,
/area/template_noop)
"ZI" = (
/obj/machinery/door/poddoor/preopen{
	id = "barShutters";
	name = "privacy shutters"
	},
/obj/effect/spawner/structure/window/plastitanium,
/turf/open/floor/plating,
/area/template_noop)

(1,1,1) = {"
LM
HA
ZI
LM
wI
LM
ZI
LM
LM
"}
(2,1,1) = {"
MB
fK
zn
fK
MB
As
Xi
fK
LM
"}
(3,1,1) = {"
MB
MB
fK
MB
MB
MB
MB
MB
LM
"}
(4,1,1) = {"
MB
Ia
LM
MB
MB
LM
LM
MB
Ia
"}
(5,1,1) = {"
MB
LM
UH
Xr
qX
TD
LM
MB
LM
"}
(6,1,1) = {"
MB
Et
nl
nu
MB
Cj
MB
MB
zf
"}
(7,1,1) = {"
MB
fF
io
Fd
MB
io
MB
MB
ZI
"}
(8,1,1) = {"
MB
mh
Ea
oK
qX
tk
Ia
MB
zf
"}
(9,1,1) = {"
MB
mh
LM
MB
MB
LM
LM
MB
WE
"}
(10,1,1) = {"
mt
bG
oV
oV
oV
oV
MB
Gy
LM
"}
(11,1,1) = {"
ab
fP
gj
SG
SG
sO
iB
gw
LM
"}
(12,1,1) = {"
LM
NX
vA
NX
Af
DU
NX
ni
LM
"}
(13,1,1) = {"
iT
Lv
Lv
ts
DW
Lv
mn
dJ
LM
"}
(14,1,1) = {"
bI
MB
MB
Dc
MB
MB
MB
MB
LM
"}
(15,1,1) = {"
MB
MB
MB
kV
MB
gH
Hx
tN
LM
"}
