//MAP CONVERTED BY dmm2tgm.py THIS HEADER COMMENT PREVENTS RECONVERSION, DO NOT REMOVE
"aa" = (
/obj/machinery/atmospherics/components/unary/vent_scrubber/on/layer3{
	dir = 8
	},
/turf/open/space/basic,
/area/template_noop)
"bg" = (
/obj/structure/cable/yellow{
	icon_state = "2-8"
	},
/obj/item/radio/intercom{
	pixel_y = 26
	},
/turf/open/floor/plasteel/dark,
/area/template_noop)
"bO" = (
/turf/closed/wall,
/area/template_noop)
"bT" = (
/obj/structure/cable/yellow{
	icon_state = "4-8"
	},
/obj/machinery/requests_console{
	department = "Bar";
	departmentType = 2;
	pixel_y = 30;
	receive_ore_updates = 1
	},
/obj/machinery/camera{
	c_tag = "Bar Access";
	dir = 2
	},
/turf/open/floor/plasteel/dark,
/area/template_noop)
"dM" = (
/obj/structure/sign/poster/official/cohiba_robusto_ad{
	pixel_y = 32
	},
/obj/effect/turf_decal/tile/neutral{
	dir = 4
	},
/obj/effect/turf_decal/tile/neutral{
	dir = 8
	},
/turf/open/floor/plasteel,
/area/template_noop)
"el" = (
/obj/machinery/disposal/bin,
/obj/structure/disposalpipe/trunk,
/obj/machinery/button/door{
	id = "barshutters";
	name = "Bar Lockdown";
	pixel_x = 28;
	req_access_txt = "25"
	},
/obj/item/radio/intercom{
	pixel_y = 26
	},
/turf/open/space/basic,
/area/template_noop)
"eI" = (
/obj/machinery/power/apc{
	dir = 8;
	name = "Theatre APC";
	pixel_x = -24
	},
/obj/structure/cable/yellow{
	icon_state = "0-4"
	},
/obj/effect/turf_decal/tile/red{
	dir = 1
	},
/obj/effect/turf_decal/tile/red,
/obj/effect/turf_decal/tile/blue{
	dir = 4
	},
/obj/effect/turf_decal/tile/blue{
	dir = 8
	},
/turf/open/floor/plasteel,
/area/template_noop)
"fg" = (
/obj/structure/disposalpipe/trunk{
	dir = 1
	},
/obj/machinery/disposal/bin,
/obj/effect/turf_decal/tile/neutral{
	dir = 1
	},
/obj/effect/turf_decal/tile/neutral,
/obj/effect/turf_decal/tile/neutral{
	dir = 4
	},
/obj/effect/turf_decal/tile/neutral{
	dir = 8
	},
/obj/effect/turf_decal/bot,
/turf/open/floor/plasteel/dark,
/area/template_noop)
"fn" = (
/obj/structure/disposalpipe/sorting/mail/flip{
	dir = 4;
	sortType = 19
	},
/turf/open/space/basic,
/area/template_noop)
"fQ" = (
/turf/open/space/basic,
/area/template_noop)
"fX" = (
/obj/structure/disposalpipe/segment{
	dir = 6
	},
/obj/effect/turf_decal/tile/red{
	dir = 1
	},
/obj/effect/turf_decal/tile/red,
/obj/effect/turf_decal/tile/blue{
	dir = 4
	},
/obj/effect/turf_decal/tile/blue{
	dir = 8
	},
/turf/open/floor/plasteel,
/area/template_noop)
"iC" = (
/obj/machinery/vending/autodrobe,
/obj/machinery/computer/security/telescreen/entertainment{
	pixel_y = 32
	},
/turf/open/floor/plasteel/dark,
/area/template_noop)
"kQ" = (
/obj/machinery/door/airlock{
	name = "Service Access";
	req_access_txt = "0";
	req_one_access_txt = "22;25;26;28;35;37;38;46"
	},
/obj/structure/disposalpipe/segment,
/obj/effect/turf_decal/stripes/line{
	dir = 1
	},
/obj/effect/turf_decal/stripes/line,
/obj/machinery/door/firedoor,
/turf/open/floor/plasteel/dark,
/area/template_noop)
"lh" = (
/obj/structure/cable/yellow{
	icon_state = "1-8"
	},
/obj/structure/disposalpipe/segment,
/obj/machinery/light_switch{
	pixel_x = 24;
	pixel_y = 24
	},
/obj/structure/mirror{
	pixel_x = 28;
	pixel_y = -2
	},
/obj/effect/turf_decal/tile/red{
	dir = 1
	},
/obj/effect/turf_decal/tile/red,
/obj/effect/turf_decal/tile/blue{
	dir = 4
	},
/obj/effect/turf_decal/tile/blue{
	dir = 8
	},
/obj/machinery/atmospherics/pipe/simple/scrubbers/hidden/layer3,
/obj/machinery/atmospherics/pipe/simple/supply/hidden/layer1,
/turf/open/floor/plasteel,
/area/template_noop)
"lp" = (
/obj/machinery/atmospherics/pipe/simple/scrubbers/hidden/layer3{
	dir = 4
	},
/obj/machinery/atmospherics/components/unary/vent_pump/on/layer1{
	dir = 8
	},
/turf/open/space/basic,
/area/template_noop)
"na" = (
/obj/structure/disposalpipe/segment,
/turf/open/space/basic,
/area/template_noop)
"oh" = (
/obj/machinery/door/airlock/maintenance{
	name = "Theatre Maintenance";
	req_access_txt = "46"
	},
/obj/structure/cable/yellow{
	icon_state = "1-2"
	},
/obj/structure/disposalpipe/segment,
/obj/machinery/atmospherics/pipe/simple/supply/hidden/layer1,
/obj/machinery/atmospherics/pipe/simple/scrubbers/hidden/layer3,
/turf/open/floor/plating,
/area/template_noop)
"oP" = (
/obj/machinery/door/poddoor/shutters/preopen{
	id = "barshutters";
	name = "bar shutters"
	},
/obj/machinery/atmospherics/pipe/simple/supply/hidden/layer1,
/obj/machinery/atmospherics/pipe/simple/scrubbers/hidden/layer3,
/turf/open/space/basic,
/area/template_noop)
"pa" = (
/obj/machinery/atmospherics/pipe/simple/scrubbers/hidden/layer3{
	dir = 4
	},
/turf/open/space/basic,
/area/template_noop)
"pq" = (
/obj/structure/closet/crate/wooden/toy,
/obj/item/lipstick/random,
/obj/item/clothing/gloves/color/rainbow,
/obj/effect/turf_decal/tile/neutral{
	dir = 1
	},
/obj/effect/turf_decal/tile/neutral,
/obj/effect/turf_decal/tile/neutral{
	dir = 4
	},
/obj/effect/turf_decal/tile/neutral{
	dir = 8
	},
/turf/open/floor/plasteel/dark,
/area/template_noop)
"pr" = (
/obj/structure/chair{
	dir = 4
	},
/obj/effect/turf_decal/tile/neutral{
	dir = 1
	},
/obj/effect/turf_decal/tile/neutral,
/turf/open/floor/plasteel,
/area/template_noop)
"ps" = (
/obj/structure/disposalpipe/segment{
	dir = 4
	},
/obj/structure/extinguisher_cabinet{
	pixel_y = 30
	},
/turf/open/space/basic,
/area/template_noop)
"pK" = (
/obj/structure/cable/yellow{
	icon_state = "4-8"
	},
/turf/open/floor/plasteel/dark,
/area/template_noop)
"qW" = (
/obj/machinery/light/small{
	dir = 1
	},
/obj/structure/cable/yellow{
	icon_state = "4-8"
	},
/obj/item/radio/intercom{
	pixel_y = 26
	},
/obj/effect/turf_decal/tile/red{
	dir = 1
	},
/obj/effect/turf_decal/tile/red,
/obj/effect/turf_decal/tile/blue{
	dir = 4
	},
/obj/effect/turf_decal/tile/blue{
	dir = 8
	},
/turf/open/floor/plasteel,
/area/template_noop)
"ri" = (
/obj/machinery/newscaster{
	pixel_x = -32;
	pixel_y = 1
	},
/obj/machinery/atmospherics/pipe/simple/scrubbers/hidden/layer3,
/obj/machinery/atmospherics/pipe/simple/supply/hidden/layer1,
/turf/open/space/basic,
/area/template_noop)
"rj" = (
/obj/structure/cable/yellow{
	icon_state = "4-8"
	},
/obj/effect/turf_decal/tile/red{
	dir = 1
	},
/obj/effect/turf_decal/tile/red,
/obj/effect/turf_decal/tile/blue{
	dir = 4
	},
/obj/effect/turf_decal/tile/blue{
	dir = 8
	},
/turf/open/floor/plasteel,
/area/template_noop)
"rD" = (
/obj/effect/turf_decal/tile/neutral{
	dir = 4
	},
/obj/effect/turf_decal/tile/neutral{
	dir = 8
	},
/turf/open/floor/plasteel,
/area/template_noop)
"vp" = (
/obj/machinery/door/airlock{
	name = "Bar Access";
	req_access_txt = "25"
	},
/obj/effect/turf_decal/stripes/line{
	dir = 4
	},
/obj/effect/turf_decal/stripes/line{
	dir = 8
	},
/obj/machinery/door/firedoor,
/turf/open/floor/plasteel/dark,
/area/template_noop)
"vJ" = (
/obj/machinery/door/airlock{
	name = "Theatre Storage";
	req_access_txt = "46"
	},
/obj/structure/disposalpipe/segment,
/obj/effect/turf_decal/tile/neutral{
	dir = 1
	},
/obj/effect/turf_decal/tile/neutral,
/obj/effect/turf_decal/tile/neutral{
	dir = 4
	},
/obj/effect/turf_decal/tile/neutral{
	dir = 8
	},
/obj/effect/turf_decal/stripes/line,
/obj/effect/turf_decal/stripes/line{
	dir = 1
	},
/obj/machinery/door/firedoor,
/turf/open/floor/plasteel/dark,
/area/template_noop)
"vM" = (
/obj/structure/disposalpipe/segment{
	dir = 9
	},
/obj/item/cardboard_cutout,
/obj/structure/mirror{
	pixel_x = 28;
	pixel_y = -2
	},
/obj/effect/turf_decal/tile/red{
	dir = 1
	},
/obj/effect/turf_decal/tile/red,
/obj/effect/turf_decal/tile/blue{
	dir = 4
	},
/obj/effect/turf_decal/tile/blue{
	dir = 8
	},
/obj/machinery/atmospherics/pipe/simple/scrubbers/hidden/layer3{
	dir = 9
	},
/obj/machinery/atmospherics/pipe/simple/supply/hidden/layer1{
	dir = 9
	},
/turf/open/floor/plasteel,
/area/template_noop)
"wa" = (
/obj/structure/disposalpipe/segment{
	dir = 4
	},
/turf/open/floor/plasteel/dark,
/area/template_noop)
"wh" = (
/obj/machinery/light{
	dir = 1
	},
/obj/machinery/airalarm{
	pixel_y = 24
	},
/obj/effect/turf_decal/tile/neutral{
	dir = 4
	},
/turf/open/floor/plasteel,
/area/template_noop)
"wP" = (
/obj/machinery/atmospherics/components/unary/vent_scrubber/on/layer3{
	dir = 4
	},
/turf/open/space/basic,
/area/template_noop)
"wU" = (
/obj/machinery/atmospherics/pipe/simple/scrubbers/hidden/layer3{
	dir = 5
	},
/obj/machinery/atmospherics/pipe/simple/supply/hidden/layer1{
	dir = 5
	},
/turf/open/space/basic,
/area/template_noop)
"xn" = (
/obj/machinery/door/airlock/public/glass{
	name = "Bar"
	},
/obj/machinery/door/poddoor/shutters/preopen{
	id = "barshutters";
	name = "bar shutters"
	},
/obj/effect/turf_decal/stripes/line{
	dir = 4
	},
/obj/effect/turf_decal/stripes/line{
	dir = 8
	},
/obj/machinery/door/firedoor,
/turf/open/floor/plasteel,
/area/template_noop)
"xv" = (
/obj/structure/disposalpipe/segment,
/obj/machinery/light/small{
	dir = 4
	},
/turf/open/space/basic,
/area/template_noop)
"xF" = (
/obj/machinery/atmospherics/pipe/simple/supply/hidden/layer1,
/obj/machinery/atmospherics/pipe/simple/scrubbers/hidden/layer3,
/turf/open/space/basic,
/area/template_noop)
"xQ" = (
/obj/machinery/door/poddoor/shutters/preopen{
	id = "barshutters";
	name = "bar shutters"
	},
/obj/effect/spawner/structure/window,
/turf/open/floor/plating,
/area/template_noop)
"yg" = (
/obj/structure/dresser,
/obj/machinery/light{
	dir = 1
	},
/obj/structure/sign/poster/contraband/clown{
	pixel_y = 32
	},
/turf/open/floor/plasteel/dark,
/area/template_noop)
"yL" = (
/obj/machinery/door/airlock/public/glass{
	name = "Bar"
	},
/obj/effect/turf_decal/stripes/line,
/obj/effect/turf_decal/stripes/line{
	dir = 1
	},
/obj/machinery/door/firedoor,
/obj/machinery/atmospherics/pipe/simple/supply/hidden/layer1,
/obj/machinery/atmospherics/pipe/simple/scrubbers/hidden/layer3,
/turf/open/floor/plasteel,
/area/template_noop)
"Bt" = (
/obj/machinery/vending/boozeomat,
/turf/closed/wall,
/area/template_noop)
"Ca" = (
/obj/structure/cable/yellow{
	icon_state = "4-8"
	},
/obj/effect/landmark/start/mime,
/obj/effect/turf_decal/tile/red{
	dir = 1
	},
/obj/effect/turf_decal/tile/red,
/obj/effect/turf_decal/tile/blue{
	dir = 4
	},
/obj/effect/turf_decal/tile/blue{
	dir = 8
	},
/turf/open/floor/plasteel,
/area/template_noop)
"Cx" = (
/obj/structure/chair,
/obj/item/clothing/head/bowler,
/obj/effect/turf_decal/tile/neutral{
	dir = 4
	},
/obj/effect/turf_decal/tile/neutral{
	dir = 4
	},
/turf/open/floor/plasteel,
/area/template_noop)
"Du" = (
/obj/structure/disposalpipe/junction/flip{
	dir = 1
	},
/obj/machinery/firealarm{
	dir = 8;
	pixel_x = 28
	},
/turf/open/space/basic,
/area/template_noop)
"Es" = (
/obj/structure/chair{
	dir = 8
	},
/obj/effect/turf_decal/tile/neutral{
	dir = 1
	},
/obj/effect/turf_decal/tile/neutral,
/turf/open/floor/plasteel,
/area/template_noop)
"EF" = (
/obj/structure/disposalpipe/segment{
	dir = 4
	},
/obj/effect/landmark/start/clown,
/obj/effect/turf_decal/tile/red{
	dir = 1
	},
/obj/effect/turf_decal/tile/red,
/obj/effect/turf_decal/tile/blue{
	dir = 4
	},
/obj/effect/turf_decal/tile/blue{
	dir = 8
	},
/obj/machinery/atmospherics/pipe/simple/scrubbers/hidden/layer3{
	dir = 4
	},
/obj/machinery/atmospherics/components/unary/vent_pump/on/layer1{
	dir = 4
	},
/turf/open/floor/plasteel,
/area/template_noop)
"Fj" = (
/obj/machinery/atmospherics/pipe/manifold/scrubbers/hidden/layer3{
	dir = 1
	},
/obj/machinery/atmospherics/pipe/simple/supply/hidden/layer1{
	dir = 6
	},
/turf/open/space/basic,
/area/template_noop)
"Gw" = (
/obj/structure/disposalpipe/segment{
	dir = 10
	},
/obj/machinery/power/apc{
	dir = 4;
	name = "Bar APC";
	pixel_x = 24
	},
/obj/structure/cable,
/turf/open/floor/plasteel/dark,
/area/template_noop)
"Ij" = (
/obj/structure/table/wood,
/obj/item/soap,
/obj/structure/table/wood,
/obj/item/bikehorn,
/obj/item/toy/cattoy,
/obj/effect/turf_decal/tile/neutral{
	dir = 1
	},
/obj/effect/turf_decal/tile/neutral,
/obj/effect/turf_decal/tile/neutral{
	dir = 4
	},
/obj/effect/turf_decal/tile/neutral{
	dir = 8
	},
/turf/open/floor/plasteel/dark,
/area/template_noop)
"Lk" = (
/obj/structure/disposalpipe/segment,
/obj/machinery/newscaster{
	pixel_x = 32;
	pixel_y = 1
	},
/turf/open/space/basic,
/area/template_noop)
"LT" = (
/obj/structure/sign/barsign,
/turf/closed/wall,
/area/template_noop)
"Mu" = (
/obj/structure/disposalpipe/segment{
	dir = 4
	},
/obj/machinery/camera{
	c_tag = "Theatre Storage";
	dir = 1
	},
/obj/effect/turf_decal/tile/red{
	dir = 1
	},
/obj/effect/turf_decal/tile/red,
/obj/effect/turf_decal/tile/blue{
	dir = 4
	},
/obj/effect/turf_decal/tile/blue{
	dir = 8
	},
/turf/open/floor/plasteel,
/area/template_noop)
"Nf" = (
/obj/machinery/door/airlock/public/glass{
	name = "Bar"
	},
/obj/effect/turf_decal/stripes/line,
/obj/effect/turf_decal/stripes/line{
	dir = 1
	},
/obj/machinery/door/firedoor,
/turf/open/floor/plasteel,
/area/template_noop)
"Nn" = (
/obj/machinery/door/airlock/public/glass{
	name = "Bar"
	},
/obj/machinery/door/poddoor/shutters/preopen{
	id = "barshutters";
	name = "bar shutters"
	},
/obj/effect/turf_decal/stripes/line,
/obj/effect/turf_decal/stripes/line{
	dir = 1
	},
/obj/machinery/door/firedoor,
/turf/open/floor/plasteel,
/area/template_noop)
"NS" = (
/obj/machinery/firealarm{
	dir = 1;
	pixel_y = 27
	},
/obj/structure/chair,
/obj/item/clothing/mask/cigarette,
/obj/effect/turf_decal/tile/neutral{
	dir = 4
	},
/obj/effect/turf_decal/tile/neutral{
	dir = 8
	},
/turf/open/floor/plasteel,
/area/template_noop)
"Ox" = (
/obj/structure/disposalpipe/segment{
	dir = 4
	},
/obj/machinery/light/small{
	dir = 2
	},
/turf/open/floor/plasteel/dark,
/area/template_noop)
"OM" = (
/obj/machinery/light{
	dir = 1
	},
/obj/effect/turf_decal/tile/neutral{
	dir = 1
	},
/obj/effect/turf_decal/tile/neutral{
	dir = 1
	},
/turf/open/floor/plasteel,
/area/template_noop)
"OP" = (
/obj/machinery/atmospherics/pipe/simple/scrubbers/hidden/layer3{
	dir = 4
	},
/obj/machinery/atmospherics/pipe/simple/supply/hidden/layer1{
	dir = 8
	},
/turf/open/space/basic,
/area/template_noop)
"Po" = (
/obj/machinery/disposal/bin,
/obj/structure/disposalpipe/trunk{
	dir = 8
	},
/turf/open/space/basic,
/area/template_noop)
"Qd" = (
/obj/structure/disposalpipe/segment{
	dir = 5
	},
/turf/open/space/basic,
/area/template_noop)
"Qf" = (
/obj/effect/turf_decal/tile/neutral{
	dir = 4
	},
/obj/item/kirbyplants/random,
/obj/effect/turf_decal/tile/neutral{
	dir = 8
	},
/turf/open/floor/plasteel,
/area/template_noop)
"QG" = (
/obj/structure/table,
/obj/item/reagent_containers/food/snacks/donut,
/obj/effect/turf_decal/tile/neutral{
	dir = 1
	},
/turf/open/floor/plasteel,
/area/template_noop)
"Tc" = (
/obj/structure/disposalpipe/segment{
	dir = 4
	},
/obj/machinery/camera{
	c_tag = "Bar Starboard";
	dir = 1
	},
/obj/machinery/light{
	light_color = "#c9d3e8"
	},
/turf/open/space/basic,
/area/template_noop)
"Ul" = (
/obj/structure/disposalpipe/sorting/mail{
	dir = 4;
	sortType = 18
	},
/obj/machinery/requests_console{
	department = "Theatre";
	departmentType = 0;
	name = "theatre RC";
	pixel_x = -32;
	pixel_y = -32
	},
/obj/effect/turf_decal/tile/red{
	dir = 1
	},
/obj/effect/turf_decal/tile/red,
/obj/effect/turf_decal/tile/blue{
	dir = 4
	},
/obj/effect/turf_decal/tile/blue{
	dir = 8
	},
/obj/machinery/atmospherics/components/unary/vent_scrubber/on/layer3{
	dir = 4
	},
/turf/open/floor/plasteel,
/area/template_noop)
"WN" = (
/obj/machinery/door/airlock/public/glass{
	name = "Bar"
	},
/obj/structure/sign/poster/random{
	pixel_y = 32
	},
/obj/machinery/door/poddoor/shutters/preopen{
	id = "barshutters";
	name = "bar shutters"
	},
/obj/effect/turf_decal/stripes/line{
	dir = 4
	},
/obj/effect/turf_decal/stripes/line{
	dir = 8
	},
/obj/machinery/door/firedoor,
/turf/open/floor/plasteel,
/area/template_noop)
"Xs" = (
/obj/structure/disposalpipe/segment{
	dir = 4
	},
/turf/open/space/basic,
/area/template_noop)
"Yy" = (
/obj/structure/table/wood,
/obj/machinery/airalarm{
	pixel_y = 22
	},
/obj/item/instrument/accordion{
	pixel_y = 4
	},
/turf/open/floor/plasteel/dark,
/area/template_noop)
"ZR" = (
/obj/machinery/door/poddoor/shutters/preopen{
	id = "barshutters";
	name = "bar shutters"
	},
/turf/open/space/basic,
/area/template_noop)
"ZY" = (
/obj/effect/turf_decal/tile/neutral{
	dir = 4
	},
/turf/open/floor/plasteel,
/area/template_noop)

(1,1,1) = {"
bO
bT
wa
bO
fQ
fQ
fQ
fQ
fQ
fQ
xQ
Es
"}
(2,1,1) = {"
Bt
pK
Ox
bO
fQ
fQ
fQ
fQ
fQ
fQ
LT
OM
"}
(3,1,1) = {"
bO
bg
Gw
kQ
Qd
fQ
fQ
fQ
fQ
fQ
bO
pr
"}
(4,1,1) = {"
bO
vp
bO
bO
ps
fQ
fQ
wP
fQ
fQ
xQ
QG
"}
(5,1,1) = {"
ri
wU
fQ
fQ
Xs
fQ
fQ
pa
fQ
fQ
xQ
Es
"}
(6,1,1) = {"
fQ
OP
fQ
fQ
Xs
fQ
fQ
pa
fQ
fQ
bO
bO
"}
(7,1,1) = {"
fQ
lp
fQ
fQ
Xs
fQ
fQ
Fj
xF
xF
oP
yL
"}
(8,1,1) = {"
fQ
aa
fQ
fQ
Xs
fQ
fQ
lp
fQ
fQ
ZR
Nf
"}
(9,1,1) = {"
fQ
fQ
fQ
fQ
Xs
fQ
fQ
pa
fQ
fQ
ZR
Nf
"}
(10,1,1) = {"
fQ
fQ
fQ
fQ
Xs
fQ
fQ
pa
fQ
fQ
bO
bO
"}
(11,1,1) = {"
el
na
xv
na
fn
fQ
fQ
pa
fQ
fQ
xQ
Qf
"}
(12,1,1) = {"
bO
bO
bO
bO
ps
fQ
fQ
aa
fQ
fQ
xQ
Cx
"}
(13,1,1) = {"
Yy
eI
fX
vJ
Du
Lk
na
na
na
Qd
bO
NS
"}
(14,1,1) = {"
yg
Ca
Mu
bO
bO
bO
fQ
fQ
fQ
Tc
bO
wh
"}
(15,1,1) = {"
iC
rj
Ul
fg
bO
fQ
fQ
fQ
fQ
Xs
Nn
rD
"}
(16,1,1) = {"
bO
qW
EF
Ij
bO
fQ
fQ
fQ
fQ
Xs
Nn
ZY
"}
(17,1,1) = {"
oh
lh
vM
pq
bO
fQ
fQ
fQ
fQ
Po
bO
dM
"}
(18,1,1) = {"
bO
bO
bO
bO
bO
bO
bO
WN
xn
bO
bO
bO
"}
